border_size=1
usage=map

Gs^Ft       , Gs^Ft       , Gs^Ft       , Gs^Ft       , Gs^Ft       , Gs          , Gs^Ft       , Gs          , Gs          , Gs^Ft       , Hh          , Hh          , Mm          , Mm^Xm       , Mm^Xm       , Mm^Xm       , Mm^Xm       , Mm          , Hh          , Gs          , Gs          , Gs^Ft       , Ds          , Ds          , Wwt         , Wwt         , Wwt         , Wot         , Wot         , Wot         , Wot         , Wot         , Wot         , Wot         , Wot         , Wot         , Wot         , Wot         , Wot         , Wot         , Wot         , Wot         , Wot         , Wot         , Wot         , Wot         , Wot         , Wot         , Wot         , Wot         
Gs^Ft       , Gs^Ft       , Gs^Ft       , Gs^Ft       , Gs^Es       , Gs^Ft       , Hh          , Gs^Ft       , Gs          , Hh          , Mm          , Mm          , Mm          , Mm^Xm       , Mm^Xm       , Mm^Xm       , Mm^Xm       , Mm          , Hh          , Gs          , Gd^Vc       , Ds          , Ds          , Wwt         , Wwt         , Wwt         , Wot         , Wot         , Wot         , Wot         , Wot         , Wot         , Wot         , Wot         , Wot         , Wot         , Wot         , Wot         , Wot         , Wot         , Wot         , Wot         , Wot         , Wot         , Wot         , Wot         , Wot         , Wot         , Wot         , Wot         
Gs^Ft       , Gs^Ft       , Gs^Ft       , Gs^Ft       , Ce          , Gd          , Gd^Es       , Gs          , Gs^Ft       , Gs          , Hh          , Mm          , Mm          , Mm          , Hh          , Mm          , Mm          , Mm          , Mm          , Gs          , Hd          , Ds          , Wwt         , Wwt         , Wwt         , Wwt         , Wot         , Wot         , Wot         , Wot         , Wot         , Wot         , Wot         , Wot         , Wot         , Wot         , Wot         , Wot         , Wot         , Wot         , Wot         , Wot         , Wot         , Wot         , Wot         , Wot         , Wot         , Wot         , Wot         , Wot         
Gs^Ft       , Gs^Ft       , Ce          , Ce          , 5 Ke        , Ce          , Ce          , Gs^Vc       , Gs          , Gs^Ft       , Gs          , Mm          , Mm          , Mm          , Hh          , Mm          , Mm          , Mm          , Md          , Hhd         , Dd          , Ds          , Wwt         , Wwt         , Wwt         , Wot         , Wot         , Wot         , Wot         , Wot         , Wot         , Wot         , Wot         , Wot         , Wot         , Wot         , Wot         , Wot         , Wot         , Wot         , Wot         , Wot         , Wot         , Wot         , Wot         , Wot         , Wot         , Wot         , Wot         , Wot         
Gs^Ft       , Gd^Es       , Hhd         , Ce          , Ce          , Ce          , Gd^Es       , Gs^Ft       , Gs          , Gs^Ft       , Gs          , Hh          , Hh          , Hh          , Mm          , Mm          , Mm          , Mm          , Md          , Hhd         , Hd          , Dd          , Ds          , Wwt         , Wwt         , Wot         , Wot         , Wot         , Wot         , Wot         , Wot         , Wot         , Wot         , Wot         , Wot         , Wot         , Wwt         , Wot         , Wwt         , Wot         , Wot         , Wot         , Wot         , Wot         , Wot         , Wot         , Wot         , Wot         , Wot         , Wot         
Gs^Ft       , Gs^Ft       , Gs^Ft       , Gd^Ft       , Hhd         , Hhd         , Gd^Es       , Gd^Es       , Gs^Ft       , Gs          , Gs          , Gs          , Gs          , Hh          , Hh          , Hh          , Hh          , Hh          , Mm          , Hhd         , Hhd         , Dd          , Ds          , Wwt         , Wwt         , Wwt         , Wot         , Wot         , Wot         , Wot         , Wot         , Wot         , Wwt         , Wwt         , Wwt         , Wwt         , Wwt         , Wwt         , Wwt         , Wwt         , Wot         , Wot         , Wot         , Wot         , Wot         , Wot         , Wot         , Wot         , Wot         , Wot         
Gs^Ft       , Gs^Ft       , Gs^Vc       , Gs^Ft       , Gs^Ft       , Gs^Ft       , Gs^Ft       , Gs          , Gs          , Gs          , Gs^Vc       , Gs          , Gs          , Gs          , Gs          , Gs          , Gs          , Ww          , Hh          , Mm          , Md          , Gs          , Ds          , Wwrt        , Wwrt        , Wwt         , Wwt         , Wot         , Wot         , Wot         , Wot         , Wot         , Wwt         , Wwt         , Wwrt        , Wwt         , Ds          , Wwt         , Wwt         , Wwt         , Wot         , Wot         , Wot         , Wot         , Wot         , Wot         , Wot         , Wot         , Wot         , Wot         
Gs^Ft       , Gs          , Gs          , Gs^Ft       , Gs^Ft       , Gs^Ft       , Gs^Ft       , Gs          , Hh          , Hh          , Hh          , Hh          , Hh          , Gs          , Hh          , Gs          , Gs          , Gs          , Gs          , Mm          , Gd          , Gd          , Gs          , Gs          , Ds          , Wwt         , Wwt         , Wwt         , Wot         , Wwt         , Wwt         , Wwt         , Wwt         , Wwrt        , Gs^Ft       , Ds          , Ds          , Ds          , Wwt         , Wwt         , Wot         , Wot         , Wot         , Wot         , Wot         , Wot         , Wot         , Wot         , Wot         , Wot         
Gs^Ft       , Gs^Ft       , Hh          , Gs          , Gs^Ft       , Gs^Ft       , Gs^Ft       , Gs          , Mm          , Mm          , Mm          , Mm          , Mm          , Hh          , Hh          , Gs          , Gs          , Gs          , Gs          , Hh          , Gd          , Gd          , Gd          , Ds          , Wwrt        , Wwt         , Wwrt        , Wwt         , Wwt         , Wwt         , Wwt         , Wwt         , Ds          , Gs^Ft       , Gs          , Ds          , Ds          , Ds          , Wwt         , Wwt         , Wot         , Wot         , Wot         , Wot         , Wot         , Wot         , Wot         , Wot         , Wot         , Wot         
Gs^Ft       , Gs^Ft       , Gs^Ft       , Gs          , Gs^Ft       , Gs^Ft       , Gs          , Hh          , Mm          , Mm          , Mm^Xm       , Mm          , Mm          , Hh          , Mm          , Hh          , Hh          , Hh          , Hh          , Gs          , Gs          , Gd          , Gs^Ft       , Ds          , Gs^Ft       , Wwrt        , Gs^Vht      , Wwt         , Wwt         , Wwt         , Wwt         , Wwt         , Ds          , Gs^Ft       , Gs          , Wwt^Es      , Wwt^Es      , Wwt         , Wwt         , Wot         , Wot         , Wot         , Wot         , Wot         , Wot         , Wot         , Wot         , Wot         , Wot         , Wot         
Gs          , Gs^Ft       , Gs^Ft       , Gs^Ft       , Gs^Ft       , Gs^Ft       , Gs^Ft       , Mm          , Mm          , Mm          , Mm          , Mm^Xm       , Mm          , Mm          , Mm          , Mm          , Hh          , Gs^Vc       , Gs          , Gs          , Gs          , Gs^Ft       , Gs^Ft       , Gs^Ft       , Ce          , Gs^Ft       , Gs^Ft       , Rd          , Ch          , Rd          , Gs^Ft       , Ds          , Gs^Ft       , Gs          , Ds          , Wwt^Es      , Wwt         , Wwt         , Wot         , Wot         , Wot         , Wot         , Wot         , Wot         , Wot         , Wot         , Wot         , Wot         , Wot         , Wot         
Gs^Ft       , Gs^Ft       , Gs^Ft       , Gs^Ft       , Gs^Ft       , Gs^Ft       , Gs          , Hh          , Mm          , Mm          , Mm          , Mm          , Mm          , Mm          , Mm          , Mm^Xm       , Mm          , Hh          , Hh          , Gs          , Gs          , Gs          , Gs^Ft       , Hh          , Gs^Ft       , Re          , 1 Gs^Vc     , Ch          , 3 Kh        , Ch          , Gs^Vht      , Re          , Gs          , Gs          , Ds          , Wwt         , Wwt         , Wwt         , Wot         , Wot         , Wot         , Wot         , Wot         , Wot         , Wot         , Wot         , Wot         , Wot         , Wot         , Wot         
Gs          , Gs^Ft       , Gs^Ft       , Gs^Ft       , Ss^Vhs      , Gs^Ft       , Rd          , Gs          , Hh          , Mm          , Mm          , Mm          , Hh          , Mm          , Md          , Mm^Xm       , Mm^Xm       , Mm          , Hh          , Gs          , Gs          , Gs^Ft       , Gs^Ft       , Gs^Ft       , Gs          , Ce          , Gs^Ft       , Chr         , Ch          , Ch          , Gs^Ft       , Ce          , Gs^Ft       , Gs^Ft       , Dd          , Ds          , Wwt         , Wwt         , Wot         , Wot         , Wot         , Wot         , Wot         , Wot         , Wot         , Wot         , Wot         , Wot         , Wot         , Wot         
Gs^Ft       , Gd          , Rd          , Ss          , Gs^Ft       , Gd^Fmw      , Gs^Ft       , Gd          , Gs          , Hh          , Gs          , Hh          , Gs          , Hh          , Hhd         , Md          , Md          , Mm          , Mm          , Hh          , Gs          , Gs^Ft       , Gs^Ft       , Gs^Ft       , Gs^Ft       , Ce          , Ce          , Re          , Re          , Gs^Vc       , Ce          , Ce          , Gs^Ft       , Ds          , Wwrt        , Wwt         , Wwt         , Wwt         , Wwt         , Wot         , Wot         , Wot         , Wot         , Wot         , Wot         , Wot         , Wot         , Wot         , Wot         , Wot         
Gd^Fmw      , Gs^Ft       , Gd^Fmw      , Ss          , Ss          , Ss          , Gs^Ft       , Gd          , Ss          , Gs^Ft       , Gs^Ft       , Gs          , Gd          , Rd          , Hhd         , Hhd         , Md          , Mm          , Mm          , Hh          , Hh          , Gs^Ft       , Gs          , Gs^Ft       , Gs^Ft       , Gs^Vht      , Re          , Gs^Ft       , Ce          , Gs^Ft       , Gs          , Gs^Vc       , Gs          , Rd          , Wwrt        , Ds          , Ds          , Wwt         , Wwt         , Wot         , Wot         , Wot         , Wot         , Wot         , Wot         , Wot         , Wot         , Wot         , Wot         , Wot         
Gs^Ft       , Ss          , Ss          , Gs^Ft       , Gs^Ft       , Gd^Fmw      , Ss          , Gd^Fmw      , Gd^Fmw      , Ss          , Ss          , Gs^Ft       , Hhd         , Gd          , Gd          , Hhd         , Mm          , Mm^Xm       , Mm          , Mm          , Hh          , Gs          , Gs^Ft       , Gs^Ft       , Gs^Ft       , Gs^Ft       , Re          , Gs^Ft       , Gs^Ft       , Gs^Ft       , Gs^Ft       , Gs^Ft       , Gs^Ft       , Rd          , Rd          , Ds          , Ds          , Wwt         , Wwt         , Wwt         , Wot         , Wot         , Wot         , Wot         , Wot         , Wot         , Wot         , Wot         , Wot         , Wot         
Gs^Ft       , Ss          , Ss          , Gd^Fmw      , Gd^Fmw      , Gd^Fmw      , Ss          , Ss          , Gs^Ft       , Ss          , Gd^Fmw      , Gs^Ft       , Gs^Ft       , Gd          , Gd          , Hhd         , Hh          , Mm          , Mm          , Hh          , Gs          , Gs          , Gs          , Gs^Ft       , Re          , Re          , Hh          , Gs^Ft       , Gs^Ft       , Gs^Vht      , Gs          , Gs^Ft       , Gs          , Gs^Ft       , Gs          , Dd^Do       , Ds          , Ds          , Wwt         , Wwt         , Wot         , Wot         , Wot         , Wot         , Wot         , Wot         , Wot         , Wot         , Wot         , Wot         
Gs^Ft       , Gd^Fmw      , Gs^Ft       , Ss          , Gd^Fmw      , Gd^Fmw      , Gs^Ft       , Ss          , Gs^Ft       , Gs^Ft       , Gs^Ft       , Gs^Ft       , Gd^Fmw      , Gd          , Gd          , Gd          , Hh          , Mm          , Hh          , Mm          , Hh          , Gs          , Ww          , Gs^Ft       , Re          , Hh          , Gs^Ft       , Gs^Ft       , Gs^Ft       , Gs^Ft       , Gs^Ft       , Gs^Ft       , Gs^Ft       , Gs^Ft       , Gs^Ft       , Gs^Ft       , Ds          , Ds          , Wwt         , Wwt         , Wwt         , Wot         , Wot         , Wot         , Wot         , Wot         , Wot         , Wot         , Wot         , Wot         
Ss          , Gs^Ft       , Ss          , Gs^Ft       , Ss          , Ss          , Ss          , Gs^Ft       , Gd^Fmw      , Ss          , Gs^Ft       , Gs^Ft       , Ss          , Gd^Fmw      , Gd^Fmw      , Gs          , Gs          , Hh          , Gs          , Hh          , Gs          , Gs          , Gs          , Gs          , Re          , Gs^Ft       , Gs          , Gs^Ft       , Gs^Ft       , Gs^Ft       , Hh          , Gs^Ft       , Gs^Ft       , Gs          , Gs^Ft       , Gs^Ft       , Gs          , Ds          , Ds          , Wwt         , Wwt         , Wwt         , Wot         , Wot         , Wot         , Wot         , Wot         , Wot         , Wot         , Wot         
Ss          , Gd^Fmw      , Gs^Ft       , Gs^Ft       , Ss          , Gd^Fmw      , Gd^Fmw      , Gs^Ft       , Gd^Fmw      , Gd^Fmw      , Gd^Fmw      , Ss          , Gd^Fmw      , Ss          , Gs^Ft       , Gd^Fmw      , Gs          , Gs          , Gs^Ft       , Gs          , Gs          , Hh          , Re          , Re          , Gs          , Gs^Ft       , Gs^Ft       , Gs^Ft       , Gs^Ft       , Gs^Ft       , Gs^Ft       , Gs^Ft       , Gs^Ft       , Gs^Ft       , Gs          , Gs^Ft       , Rd          , Ds          , Ds          , Wwt         , Wwt         , Wwt         , Wot         , Wot         , Wot         , Wot         , Wot         , Wot         , Wot         , Wot         
Gs^Ft       , Ss          , Gd^Fmw      , Gs^Ft       , Gd^Fmw      , Gd^Fmw      , Ss          , Gs^Ft       , Gs^Ft       , Gs          , Gs^Ft       , Gd^Fmw      , Gs^Ft       , Gs^Ft       , Gs^Ft       , Gd^Fmw      , Gs^Ft       , Gs          , Gs          , Gs          , Gs^Ft       , Gs          , Re          , Gs^Ft       , Hh          , Gs^Ft       , Hh          , Gs^Ft       , Gs^Ft       , Gs^Ft       , Gs^Ft       , Gs^Ft       , Gg          , Gs^Ft       , Gs          , Gs^Vht      , Ds          , Ds          , Wwt         , Wwt         , Wwt         , Wot         , Wot         , Wot         , Wot         , Wot         , Wot         , Wot         , Wot         , Wot         
Gs^Ft       , Gd^Fmw      , Ss          , Gs^Ft       , Gd^Fmw      , Gd^Fmw      , Gs^Ft       , Gd^Fmw      , Ss          , Gd^Fmw      , Ss          , Gs^Ft       , Gd^Fmw      , Ss          , Gs^Ft       , Gd          , Gs^Ft       , Gd^Fmw      , Ss          , Gs          , Ww          , Gs          , Re          , Hh          , Mm          , Hh          , Gs^Ft       , Gs^Ft       , Gs^Ft       , Gs^Ft       , Ww          , Ww          , Ww          , Gg          , Ww          , Wwt         , Wwt         , Wwt         , Wwt         , Wwt         , Wwt         , Wwt         , Wwt         , Wot         , Wot         , Wot         , Wot         , Wot         , Wot         , Wot         
Gd^Fmw      , Ss          , Ss          , Gd^Fmw      , Gs^Ft       , Gs          , Gd^Fmw      , Gs^Ft       , Gs^Ft       , Gs^Ft       , Gd^Fmw      , Ss          , Gd^Fmw      , Gs^Ft       , Ss          , Gs^Ft       , Gd^Fmw      , Gd^Fmw      , Ss          , Ww^Ewl      , Ww          , Gs          , Re          , Hh          , Mm          , Mm          , Hh          , Gs^Ft       , Gs^Ft       , Gg          , Ww          , Ww          , Ww          , Ww          , Gg          , Rd          , Rd          , Ds          , Dd          , Dd          , Ch          , Wwt^Bw/     , Wwt         , Wot         , Wot         , Wot         , Wot         , Wot         , Wot         , Wot         
Gs^Ft       , Ss^Vhs      , Ss          , Gd^Fmw      , Gd^Fmw      , Ss          , Gs^Ft       , Gs^Ft       , Gd^Fmw      , Gs^Ft       , Gs^Ft       , Gd^Fmw      , Gd^Fmw      , Gd^Fmw      , Gd          , Gd^Fmw      , Gd^Fmw      , Gd          , Ww^Ewf      , Ww^Ewl      , Ww          , Re          , Gs^Ft       , Gs          , Hh          , Hh          , Gs^Ft       , Gs^Ft       , Gg          , Ww          , Ww          , Ww          , Ww          , Gg          , Gs          , Gs          , Gs          , Ds          , Rd          , Dd^Do       , Ch          , Wwt         , Wwt^Bw/     , Wwt         , Wwt         , Wot         , Wot         , Wot         , Wot         , Wot         
Gs^Ft       , Gs^Ft       , Gs^Ft       , Gs^Ft       , Gs^Ft       , Gs^Ft       , Gd          , Gd^Fmw      , Ss^Vm       , Gd^Fmw      , Gd          , Rd          , Gd^Fmw      , Gs^Ft       , Gd          , Gd^Fmw      , Gs          , Ss          , Ww          , Ww          , Gs          , Re          , Gs^Ft       , Gs^Ft       , Gs          , Hh          , Gs^Ft       , Gs^Ft       , Gs^Ft       , Gg          , Gg          , Gg          , Gg          , Gs          , Gs^Ft       , Gs          , Rp          , Rr          , Ch          , Re          , Rr          , Ch          , Wwt         , Wwt         , Wwt         , Wot         , Wot         , Wot         , Wot         , Wot         
Gs          , Gd^Fmw      , Gs^Ft       , Gd^Fmw      , Gd^Fmw      , Gd          , Gs^Ft       , Gs^Ft       , Ww^Ewl      , Ww          , Ww          , Gd          , Gd          , Gd          , Gd          , Gs          , Gg^Efm      , Gg^Efm      , Gg^Efm      , Ww          , Gs          , Re          , Re          , Re          , Re          , Gs^Ft       , Gs^Ft       , Gs^Ft       , Gs^Ft       , Gs          , Gs^Ft       , Gs^Ft       , Gs          , Gs          , Gs^Ft       , Rp          , Gs^Ft       , Gs          , Gs^Ft       , Rr          , Kh          , Rr          , Ch          , Wwt^Bw/     , Wwt         , Wot         , Wot         , Wot         , Wot         , Wot         
Gs^Ft       , Ss          , Ss          , Gd^Fmw      , Gs^Ft       , Ss          , Ss          , Ww^Ewl      , Ww^Ewl      , Ww          , Ww          , Ww          , Gd          , Rd          , Gs          , Gs          , Gg^Efm      , Gg^Efm      , Gg^Efm      , Gs          , Gg^Efm      , Gs          , Gs^Ft       , Gs^Ft       , Re          , Gs^Ft       , Gs^Ft       , Gs^Ft       , Gs^Ft       , Gs^Ft       , Gs^Ft       , Gs^Ft       , Gs          , Gs^Ft       , Rp          , Re          , Gs          , Gs^Ft       , Gs          , Rr          , Rr          , Rr          , Ch          , Wwt         , Wwt^Bw/     , Wwt         , Wot         , Wot         , Wot         , Wot         
Gd^Fmw      , Gd^Fmw      , Gd^Fmw      , Gs^Ft       , Gd          , Gd^Fmw      , Rd          , Gs^Ft       , Ww          , Ww          , Ww          , Ww          , Ww          , Gd          , Gs          , Gs^Ft       , Gs          , Gg^Efm      , Gs          , Gs          , Gs          , Gs          , Gs^Ft       , Gs^Ft       , Re          , Gs^Ft       , Gs^Ft       , Gs^Ft       , Gs^Ft       , Gs^Ft       , Gs^Ft       , Gs          , Gs^Ft       , Re          , Gs^Ft       , Gs^Ft       , Gs^Ft       , Gs^Ft       , Gs^Ft       , Gs^Ft       , Ch          , Rd          , Ds          , Ch          , Wwt         , Wwt         , Wwt         , Wot         , Wot         , Wot         
Gs          , Gd^Fmw      , Ss          , Gs^Ft       , Gs^Ft       , Rd          , Gd^Fmw      , Gd^Fmw      , Gd^Fmw      , Ww^Ewl      , Gs^Ft       , Ww          , Gs^Ft       , Ww          , Gs          , Gs          , Gs^Ft       , Gs^Ft       , Gs^Ft       , Gs^Ft       , Gs          , Gs^Ft       , Gs          , Gs^Ft       , Gs^Ft       , Re          , Re          , Gs^Ft       , Gs^Ft       , Gs^Ft       , Gs^Ft       , Gs^Ft       , Re          , Re          , Gs          , Gs^Vc       , Gs          , Gs^Ft       , Gs^Ft       , Gs          , Gs          , Ds          , Ds          , Ds          , Wwt         , Wwt         , Wwt         , Wot         , Wot         , Wot         
Gs^Ft       , Gs^Ft       , Gs^Ft       , Gs^Ft       , Gs^Ft       , Rd          , Gd          , Ss          , Ss^Vhs      , Gd^Fmw      , Gs^Ft       , Gs^Ft       , Gs^Ft       , Ww          , Ww          , Gs          , Gs^Ft       , Gs^Ft       , Gs^Ft       , Gs^Ft       , Gs^Ft       , Gs          , Hh          , Gs^Ft       , Gs^Ft       , Gs^Ft       , Re          , Gs^Ft       , Re          , Gs^Ft       , Gs^Ft       , Gs^Ft       , Ce          , Gs^Ft       , Re          , Re          , Ce          , Gs          , Ds          , Dd          , Dd^Do       , Ds          , Wwt         , Wwt         , Wwt         , Wwt         , Wot         , Wot         , Wot         , Wot         
Gs^Ft       , Gs^Ft       , Gs^Ft       , Gs^Ft       , Gs^Ft       , Gs^Ft       , Gs          , Gd^Fmw      , Gs          , Gd^Fmw      , Gs          , Gs^Ft       , Gs          , Ww          , Ww          , Gs^Ft       , Gs^Ft       , Gs^Ft       , Gs^Ft       , Gs^Ft       , Gs^Ft       , Gs          , Gs^Ft       , Gs          , Gs^Ft       , Gs^Ft       , Gs          , Re          , Gs^Ft       , Re          , Ce          , Ce          , Gs^Ft       , Ce          , Gs^Ft       , Re          , Gs^Ft       , Gs          , Ds          , Dd          , Wwt         , Wwt         , Wwt         , Wwt         , Wot         , Wwt         , Wot         , Wot         , Wot         , Wot         
Gs^Ft       , Gs^Ft       , Gs^Ft       , Gs^Ft       , Gs^Ft       , Gs          , Gs^Ft       , Gs^Ft       , Gs          , Gs          , Gs          , Gs          , Hh          , Gs^Ft       , Gs          , Ww          , Ww          , Gs^Ft       , Gs          , Gs^Ft       , Gs^Ft       , Gs^Ft       , Gs^Ft       , Gs^Ft       , Gs          , Gs^Ft       , Gs^Ft       , Gs^Ft       , Gs^Ft       , Gs^Ft       , Ce          , Gs^Vht      , Gs          , Re          , Gs^Vc       , Rd          , Wwt         , Rd          , Wwrt        , Ds          , Wwt         , Wwt         , Wot         , Wot         , Wot         , Wot         , Wot         , Wot         , Wot         , Wot         
Gs^Ft       , Gs          , Gs^Ft       , Gs^Ft       , Gs^Ft       , Gs^Ft       , Gs^Ft       , Gs          , Gs^Ft       , Gs^Ft       , Gs          , Hh          , Hh          , Gs          , Gs          , Gs          , Ww          , Gs          , Gs          , Gs          , Gs^Ft       , Gs^Ft       , Gs^Ft       , Gs^Ft       , Gs          , Gs^Ft       , Gs          , Gs^Ft       , Gs^Ft       , Re          , Gs^Ft       , Gs^Ft       , Chr         , Chr         , Chr         , Rd          , Rd          , Wwt         , Wwt         , Wwt         , Wwt         , Wwt         , Wot         , Wot         , Wot         , Wot         , Wot         , Wot         , Wot         , Wot         
Gs^Ft       , Gs^Ft       , Gs^Ft       , Gs^Ft       , Gs^Ft       , Gs^Ft       , Gs^Ft       , Gs^Ft       , Gs^Ft       , Gs^Ft       , Gs          , Gs^Ft       , Gs          , Gs          , Gs^Ft       , Gs^Ft       , Gs^Ft       , Ww          , Ww          , Gs          , Gs          , Gs^Ft       , Gs^Ft       , Gs^Ft       , Gs^Ft       , Gs^Ft       , Gs^Ft       , Gs^Ft       , Gs^Vc       , Re          , Re          , Re          , Chr         , 2 Kh        , Ch          , Gs^Ft       , Gs^Ft       , Wwt         , Wwt         , Wwt         , Wot         , Wwt         , Wot         , Wot         , Wot         , Wot         , Wot         , Wot         , Wot         , Wot         
Gs^Ft       , Gs^Ft       , Gs^Ft       , Gs^Ft       , Gs^Ft       , Ww          , Gs^Ft       , Gs^Ft       , Gs          , Gs^Ft       , Gs^Ft       , Gs          , Gs^Ft       , Gs^Ft       , Gs^Ft       , Gs          , Gs          , Gs          , Ww          , Gs          , Gs          , Gs^Ft       , Gs^Ft       , Gs^Ft       , Gs^Ft       , Gs^Ft       , Ds          , Gs          , Ds          , Ce          , Gs^Ft       , Gs^Ft       , Gs^Vc       , Ch          , Gs^Ft       , Gs          , Gs^Vht      , Wwrt        , Wwt         , Wot         , Wot         , Wot         , Wot         , Wot         , Wot         , Wot         , Wot         , Wot         , Wot         , Wot         
Gs^Ft       , Gs^Ft       , Gs^Ft       , Gs^Ft       , Gs^Ft       , Gs^Ft       , Gs^Ft       , Gs^Ft       , Gs^Ft       , Gs          , Gs^Ft       , Gs^Ft       , Gs          , Gs^Ft       , Gs          , Gs^Ft       , Gs^Ft       , Gs          , Ww          , Gs^Ft       , Gs          , Gs^Ft       , Gs          , Gs          , Dd          , Dd          , Ds          , Ds          , Dd          , Ds          , Gs          , Gs^Ft       , Gs^Ft       , Gs^Ft       , Wwrt        , Wwrt        , Wwrt        , Wwt         , Wwt         , Wot         , Wot         , Wot         , Wot         , Wot         , Wot         , Wot         , Wot         , Wot         , Wot         , Wot         
Gs          , Gs^Ft       , Gs          , Gs^Ft       , Gs          , Gs^Ft       , Gs^Ft       , Gs^Ft       , Gs^Ft       , Gs^Ft       , Gs^Ft       , Gs^Ft       , Gs^Ft       , Gs^Ft       , Gs^Ft       , Gs^Ft       , Gs^Ft       , Gs^Ft       , Gs          , Ww          , Ww          , Gs          , Ww          , Gs          , Wwt         , Dd          , Wwt         , Wwt         , Ds          , Dd          , Ds          , Ds          , Ds          , Ds          , Wwt         , Wwt         , Wwt         , Wwt         , Wot         , Wot         , Wot         , Wot         , Wot         , Wot         , Wot         , Wot         , Wot         , Wot         , Wot         , Wot         
Gs          , Gs^Ft       , Gs^Ft       , Gs          , Gs^Ft       , Gs^Ft       , Gs^Ft       , Gs^Ft       , Gs^Ft       , Gs^Ft       , Gs^Ft       , Gs^Ft       , Gs^Ft       , Gs^Ft       , Gs^Ft       , Gs^Ft       , Gs          , Gs          , Gs          , Gs^Ft       , Gs          , Ww          , Gs          , Wwt         , Ds          , Wwt         , Ds          , Wwt         , Wwt         , Wwt         , Wwt         , Ds          , Wwt         , Wwt         , Wwt         , Wwt         , Wot         , Wot         , Wot         , Wot         , Wot         , Wot         , Wot         , Wot         , Wot         , Wot         , Wot         , Wot         , Wot         , Wot         
Gs^Ft       , Gs^Ft       , Gs^Vc       , Gs^Ft       , Gs^Ft       , Gs^Ft       , Gs          , Gs^Ft       , Gs^Ft       , Gs^Ft       , Gs^Ft       , Gs^Ft       , Gs^Ft       , Gs^Ft       , Gs^Ft       , Gs^Ft       , Gs^Ft       , Gs          , Gs          , Gs          , Gs          , Gs          , Gs^Ft       , Gs          , Rd          , Ds          , Wwt         , Wwt         , Wwt         , Wwt         , Wwt         , Wwt         , Wwt         , Wwt         , Wwt         , Wot         , Wot         , Wot         , Wot         , Wot         , Wot         , Wot         , Wot         , Wot         , Wot         , Wot         , Wot         , Wot         , Wot         , Wot         
Gs^Ft       , Gs^Ft       , Gs^Ft       , Gs^Ft       , Gs^Ft       , Gs^Ft       , Gs^Ft       , Gs          , Gs^Ft       , Gs          , Gs^Ft       , Gs          , Gs          , Gs^Ft       , Gs^Ft       , Gs^Ft       , Gs^Ft       , Gs          , Gs^Ft       , Gs^Vc       , Gs          , Gs^Ft       , Gs^Ft       , Rd          , Rd          , Wwrt        , Wwt         , Wwt         , Wot         , Wwt         , Wot         , Wwt         , Wot         , Wwt         , Wot         , Wot         , Wot         , Wot         , Wot         , Wot         , Wot         , Wot         , Wot         , Wot         , Wot         , Wot         , Wot         , Wot         , Wot         , Wot         
Gs^Ft       , Gs^Ft       , Gs^Ft       , Gs^Ft       , Gs^Ft       , Gs^Ft       , Gs^Ft       , Gs^Ft       , Gs          , Gs^Ft       , Gs^Ft       , Gs^Ft       , Gs          , Gs^Ft       , Gs^Ft       , Gs^Ft       , Gs          , Gs          , Gs          , Gs          , Gs^Ft       , Gs^Ft       , Rd          , Rd          , Wwrt        , Wwrt        , Wwt         , Wot         , Wot         , Wot         , Wot         , Wot         , Wwt         , Wot         , Wot         , Wot         , Wot         , Wot         , Wot         , Wot         , Wot         , Wot         , Wot         , Wot         , Wot         , Wot         , Wot         , Wot         , Wot         , Wot         
