border_size=1
usage=map

Wot         , Wot         , Wot         , Wot         , Wot         , Wot         , Wot         , Wot         , Wot         , Wot         , Wot         , Wot         , Wot         , Wot         , Wot         , Wot         , Wot         , Wot         , Wot         , Wot         , Wot         , Wot         , Wot         , Wot         , Wot         , Wot         , Wot         , Wot         , Wot         , Wot         , Wot         , Wot         , Wot         , Wot         , Wot         , Wot         , Wot         , Wot         , Wot         , Wot         , Wot         , Wot         , Wot         , Wot         
Wot         , Wot         , Wot         , Wot         , Wot         , Wot         , Wot         , Wot         , Wot         , Wot         , Wot         , Wot         , Wot         , Wot         , Wot         , Wot         , Wot         , Wot         , Wot         , Wot         , Wot         , Wot         , Wot         , Wot         , Wot         , Wot         , Wot         , Wot         , Wot         , Wot         , Wot         , Wot         , Wot         , Wot         , Wot         , Wot         , Wot         , Wot         , Wot         , Wot         , Wot         , Wot         , Wot         , Wot         
Wot         , Wot         , Wot         , Wot         , Wot         , Wot         , Wot         , Wot         , Wot         , Wot         , Wot         , Wot         , Wot         , Wot         , Wot         , Wot         , Wot         , Wot         , Wot         , Wot         , Wot         , Wot         , Wot         , Wot         , Wot         , Wot         , Wot         , Wot         , Wot         , Wot         , Wot         , Wot         , Wot         , Wot         , Wot         , Wot         , Wot         , Wot         , Wot         , Wot         , Wot         , Wot         , Wot         , Wot         
Wot         , Wot         , Wot         , Wot         , Wwt         , Wot         , Wot         , Wot         , Wot         , Wot         , Wot         , Wot         , Wot         , Wot         , Wot         , Wot         , Wot         , Wot         , Wot         , Wwt         , Wwt         , Wot         , Wot         , Wot         , Wot         , Wot         , Wot         , Wot         , Wwt         , Wot         , Wwt         , Wot         , Wot         , Wot         , Wot         , Wot         , Wot         , Wot         , Wot         , Wot         , Wot         , Wot         , Wot         , Wot         
Wot         , Wot         , Wot         , Wwt         , Wwt         , Wwt         , Wwt         , Wwt         , Wot         , Wot         , Wot         , Wot         , Wot         , Wot         , Wot         , Wot         , Wot         , Wot         , Wwt         , Wwt         , Wwt         , Wwt         , Wwt         , Wwt         , Wwt         , Wwt         , Wwt         , Wwt         , Wwt         , Wwt         , Wwt         , Wot         , Wot         , Wot         , Wot         , Wot         , Wot         , Wot         , Wot         , Wot         , Wot         , Wot         , Wot         , Wot         
Wot         , Wot         , Wot         , Wwt         , Wwt         , Wwt         , Wwt         , Wwt         , Wwt         , Wot         , Wot         , Wot         , Wot         , Wot         , Wot         , Wot         , Wwt         , Wwt         , Wwt         , Ds          , Ds          , Wwt         , Wwt         , Wwt         , Wwt         , Wwt         , Wwt         , Wwt         , Wwt         , Wwt         , Wwt         , Wwt         , Wot         , Wot         , Wot         , Wot         , Wot         , Wot         , Wot         , Wot         , Wot         , Wot         , Wot         , Wot         
Wot         , Wot         , Wot         , Wwt         , Wwt         , Gs          , Gs          , Wwt         , Wwt         , Wwt         , Wot         , Wot         , Wot         , Wot         , Wot         , Wwt         , Wwt         , Wwt         , Wwt         , Ds          , Gs          , Ds          , Wwt         , Wwt         , Wwt         , Wwt         , Wwt         , Wwt         , Wwt         , Wwt         , Wwt         , Wwt         , Wwt         , Wot         , Wot         , Wot         , Wot         , Wot         , Wot         , Wot         , Wot         , Wot         , Wot         , Wot         
Wot         , Wot         , Wwt         , Wwt         , Gs          , Gs          , Gs^Fds      , Wwt         , Wwt         , Wwt         , Wot         , Wwt         , Wwt         , Wwt         , Wot         , Wwt         , Ds          , Ds          , Wwt         , Gs          , Gs^Fds      , Ds          , Ds          , Wwt         , Wwt         , Ds          , Ds          , Ds          , Wwt         , Wwt         , Wwt         , Wwt         , Wwt         , Wot         , Wot         , Wot         , Wot         , Wot         , Wot         , Wot         , Wot         , Wot         , Wot         , Wot         
Wot         , Wot         , Wot         , Wwt         , Wwt         , Ds          , Gs^Vh       , Gs^Fds      , Wwt         , Wwt         , Wwt         , Wwt         , Wwt         , Wwt         , Wwt         , Wwt         , Ds          , Gs          , Wwt         , Gs          , Rd          , Rd          , Ds          , Ds          , Ds          , Ds          , Gs          , Ds          , Ds          , Ds          , Wwt         , Wwt         , Wwt         , Wot         , Wot         , Wot         , Wot         , Wot         , Wot         , Wot         , Wot         , Wot         , Wot         , Wot         
Wot         , Wot         , Wot         , Wwt         , Wwt         , Ds          , Gs          , Gs^Fds      , Wwt         , Wwt         , Wwt         , Wwt         , Gg          , Gg          , Wwt         , Ds          , Gs          , Gs^Vht      , Wwt         , Gg          , Rd          , Gs          , Gs          , Ds          , Gs          , Gs^Vhr      , Gs^Es       , Gs^Fds      , Ds          , Ds          , Wwt         , Wwt         , Wot         , Wot         , Wot         , Wot         , Wot         , Wot         , Wot         , Wot         , Wot         , Wot         , Wot         , Wot         
Wot         , Wot         , Wwt         , Wwt         , Wwt         , Ds          , Rd          , Gs          , Ds          , Wwt         , Ds          , Gs          , Gs          , Gg          , Wwt         , Ds          , Gs          , Ww          , Ww          , Gg          , Gg          , Gs^Vht      , Gs          , Rd          , Rd          , Rd          , Rd          , Gs          , Gs          , Ds          , Wwt         , Wwt         , Wot         , Wot         , Wot         , Wot         , Wot         , Wot         , Wot         , Wot         , Wot         , Wot         , Wot         , Wot         
Wot         , Wot         , Wwt         , Wwt         , Ds          , Gs          , Rd          , Gs          , Rp          , Ds          , Gs          , Gs^Fds      , Gs          , Gg          , Wwt^Bw/     , Gs          , Gs          , Ww          , Gg          , Gg          , Gs          , Rd          , Rd          , Rd          , Gs^Es       , Gs^Vhr      , Re          , Gs^Fds      , Gs^Fds      , Ds          , Wwt         , Wot         , Wot         , Wot         , Wot         , Wot         , Wot         , Wot         , Wot         , Wot         , Wot         , Wot         , Wot         , Wot         
Wot         , Wot         , Wwt         , Wwt         , Ds          , Gs          , Gs          , Rp          , Rp^Vhcr     , Rd          , Gs          , Gs^Fds      , Gs^Fds      , Gg          , Ww          , Gs^Vh       , Ww          , Ww          , Gg          , Gg          , Gs^Fds      , Rd          , Gs          , Gs^Fds      , Gs^Fds      , Gg          , Re          , Gs^Fds      , Gs^Fds      , Gg          , Ds          , Wwt         , Wwt         , Wot         , Wot         , Wot         , Wot         , Wot         , Wot         , Wot         , Wot         , Wot         , Wot         , Wot         
Wot         , Wot         , Wwt         , Wwt         , Ds          , Gs^Vhr      , Gs          , Rp          , Gs          , Rd          , Rd          , Gs          , Rp          , Rp^Vhcr     , Ww          , Gs          , Ww          , Gg          , Gs          , Gs^Vhr      , Gs          , Rp          , Gs          , Gs^Vhr      , Gs^Fds      , Re          , Gs^Fds      , Gs^Fds      , Re^Fds      , Gs          , Ds          , Ds          , Wwt         , Wwt         , Wot         , Wot         , Wot         , Wot         , Wot         , Wot         , Wot         , Wot         , Wot         , Wot         
Wot         , Wot         , Wwt         , Wwt         , Wwt         , Ds          , Gs          , Gs^Fds      , Gs^Fds      , Rd          , Gs          , Rd^Es       , Gs          , Rp          , Ww          , Ww          , Ww          , Gg          , Gg          , Gs^Es       , Rp          , Gs          , Gg          , Gs^Fds      , Re          , Re          , Gs^Fds      , Gs^Fds      , Re^Fds      , Gs^Fds      , Ds          , Wwt         , Wwt         , Wot         , Wot         , Wot         , Wot         , Wot         , Wot         , Wot         , Wot         , Wot         , Wot         , Wot         
Wot         , Wot         , Wot         , Wwt         , Wwt         , Ds          , Gs          , Gs          , Rr          , Rr          , Rr^Vhc      , Gs          , Rr          , Rr          , Gg          , Ww          , Ww          , Gs          , Rp          , Rd          , Gs^Fds      , Gs          , Gs^Fds      , Gs          , Re          , Re^Fds      , Re^Fds      , Re^Vhc      , Gs^Fds      , Gs^Fds      , Ds          , Wwt         , Wwt         , Wot         , Wot         , Wot         , Wot         , Wot         , Wot         , Wot         , Wot         , Wot         , Wot         , Wot         
Wot         , Wot         , Wot         , Wwt         , Wwt         , Wwt         , Ds          , Gs          , Rd          , Ch          , Ch          , Gs^Fds      , Rr          , Rd          , Gs^Fds      , Gs^Fds      , Ww^Bsb/     , Rr          , Gs          , Gs          , Gs          , Gs          , Gs^Vhr      , Gs^Fds      , Re          , Gs^Fds      , Gs^Fds      , Gs^Fds      , Gs^Fds      , Gs^Fds      , Ds          , Ds          , Wwt         , Wwt         , Wot         , Wot         , Wot         , Wot         , Wot         , Wot         , Wot         , Wot         , Wot         , Wot         
Wot         , Wot         , Wot         , Wwt         , Wwt         , Ds          , Rr^Vhc      , Rd^Es       , Ch          , Kh          , Ch          , Rr          , Gs^Fds      , Gs          , Rr          , Rr          , Ww          , Ch          , Hh          , Hh          , Hh          , Gs          , Gs^Fds      , Gs^Fds      , Re          , Gs          , Gs^Fds      , Gs^Fds      , Gs^Fds      , Gs^Fds      , Gg          , Ds          , Wwt         , Wwt         , Wot         , Wot         , Wot         , Wot         , Wot         , Wot         , Wot         , Wot         , Wot         , Wot         
Wot         , Wot         , Wwt         , Wwt         , Ds          , Gs          , Rr          , Gs          , Gs          , Ch          , Rd          , Rd          , Rd          , Rr          , Rr^Vhc      , Gs          , Ww          , Ww          , Mm          , Mm          , Mm          , Hh^Fds      , Hh^Fds      , Gs^Fds      , Re          , Gs^Vhr      , Gs^Fds      , Gs^Fds      , Gs^Fds      , Gs^Fds      , Gg          , Ds          , Ds          , Wwt         , Wot         , Wot         , Wot         , Wot         , Wot         , Wot         , Wot         , Wot         , Wot         , Wot         
Wot         , Wot         , Wwt         , Wwt         , Ds          , Rr          , Gs          , Chr         , Gs^Fds      , Gs          , Rd          , Gs          , Gs          , Gs          , Gs          , Mm          , Mm          , Ww          , Mm          , Mm          , Mm          , Mm          , Hh^Fds      , Gs^Fds      , Gs^Fds      , Re          , Re          , Gs          , Gg          , Gg          , Ds          , Ds          , Wwt         , Wwt         , Wot         , Wot         , Wot         , Wot         , Wot         , Wot         , Wot         , Wot         , Wot         , Wot         
Wot         , Wot         , Wot         , Wwt         , Wwt         , Rr^Vhc      , Gs          , Gs          , Gs          , Gs          , Rp          , Rp^Vhcr     , Hh          , Hh          , Mm          , Mm          , Mm          , Ww          , Ww          , Mm          , Mm          , Mm          , Hh          , Gs^Fds      , Gg^Vh       , Gs^Fds      , Re          , Gs^Vht      , Gg          , Gs          , Ds          , Ds          , Wwt         , Wot         , Wot         , Wot         , Wot         , Wot         , Wot         , Wot         , Wot         , Wot         , Wot         , Wot         
Wot         , Wot         , Wot         , Wwt         , Ds          , Ds          , Rd          , Gs          , Hh          , Hh          , Rr          , Hh          , Hh          , Hh          , Mm          , Mm          , Ww          , Ww          , Ww          , Ww          , Mm          , Mm          , Gg          , Gg          , Gg          , Gs          , Rd^Es       , Rd          , Gg          , Gg          , Ds          , Wwt         , Wwt         , Wot         , Wot         , Wot         , Wot         , Wot         , Wot         , Wot         , Wot         , Wot         , Wot         , Wot         
Wot         , Wot         , Wot         , Wwt         , Ds          , Gs          , Gs          , Gs          , Gs          , Gs          , Rd          , Hh          , Hh          , Hh          , Mm          , Mm          , Ww^Bsb\     , Ww          , Ww          , Ww          , Ww^Bsb/     , Mm          , Mm          , Hh          , Rr          , Rr^Vhc      , Gg          , Gg          , Ch          , Gs^Fds      , Rr          , Ds          , Wwt^Bw/     , Wot         , Wot         , Wot         , Wot         , Wot         , Wot         , Wot         , Wot         , Wot         , Wot         , Wot         
Wot         , Wot         , Wot         , Wwt         , Wwt         , Ds          , Ds          , Gs          , Rp          , Gs^Es       , Rr          , Hh          , Hh          , Hh          , Mm          , Mm          , Ww          , Ww^Bsb\     , Khw         , Ww^Bsb/     , Ww          , Mm          , Mm          , Hh          , Hh          , Rr          , Rd          , Rr^Vhc      , Ch          , Rr          , Rr          , Rr          , Wwt         , Wwt         , Wot         , Wot         , Wot         , Wot         , Wot         , Wot         , Wot         , Wot         , Wot         , Wot         
Wot         , Wot         , Wot         , Wot         , Wwt         , Wwt         , Wwt         , Ds          , Rp^Vhcr     , Rp          , Rr          , Gs          , Hh          , Hh          , Hh          , Mm          , Mm^Bsb/     , Ww^Bsb/     , Ww          , Ww^Bsb\     , Ww^Bsb\     , Mm          , Mm          , Mm          , Hh          , Gg          , Gg          , Ch          , 2 Kh        , Rr^Vhc      , Ch          , Rd          , Rr          , Wwt^Bw/     , Wot         , Wot         , Wot         , Wot         , Wot         , Wot         , Wot         , Wot         , Wot         , Wot         
Wot         , Wot         , Wot         , Wot         , Wwt         , Wwt         , Wwt         , Ds          , Ds          , Gs          , Rd          , Rr^Vhc      , Gs          , Hh          , Hh          , Mm          , Mm          , Ww          , Ww          , Ww          , Mm          , Mm          , Mm          , Hh          , Gg          , Gg          , Rd          , Rd          , Ch          , Ch          , 1 Ch        , Ch          , Ds          , Wwt         , Wot         , Wot         , Wot         , Wot         , Wot         , Wot         , Wot         , Wot         , Wot         , Wot         
Wot         , Wot         , Wot         , Wot         , Wot         , Wwt         , Wwt         , Wwt         , Wwt         , Ds          , Gs          , Rd          , Rr          , Gs          , Hh          , Mm          , Mm          , Ww          , Ww          , Ww          , Mm          , Mm          , Rp^Vhcr     , Gg          , Rp          , Rp^Vhcr     , Rp          , Gg          , Gg          , Ch          , Rr^Vhc      , Rr          , Rr          , Wwt^Bw/     , Wot         , Wot         , Wot         , Wot         , Wot         , Wot         , Wot         , Wot         , Wot         , Wot         
Wot         , Wot         , Wot         , Wot         , Wot         , Wot         , Wwt         , Wwt         , Wwt         , Ds          , Gs          , Gs          , Rd          , Gs          , Hh          , Hh          , Mm          , Mm          , Mm          , Mm          , Mm          , Mm          , Gg          , Rp          , Gg          , Gs^Fds      , Rp^Vhcr     , Gg          , Gs          , Rr          , Ds          , Wwt         , Wwt         , Wwt         , Wot         , Wot         , Wot         , Wot         , Wot         , Wot         , Wot         , Wot         , Wot         , Wot         
Wot         , Wot         , Wot         , Wot         , Wot         , Wot         , Wot         , Wwt         , Wwt         , Ds          , Gs          , Gs          , Rr          , Gs          , Gs          , Hh          , Hh          , Mm          , Hh^Vhh      , Mm          , Mm          , Mm          , Rp          , Rp          , Gg          , Gg          , Rd          , Gs          , Gs          , Rr          , Rr          , Wwt^Bw/     , Wot         , Wot         , Wot         , Wot         , Wot         , Wot         , Wot         , Wot         , Wot         , Wot         , Wot         , Wot         
Wot         , Wot         , Wot         , Wot         , Wot         , Wot         , Wwt         , Wwt         , Wwt         , Wwt         , Ds          , Gs          , Rp          , Gs          , Gs          , Gs          , Hh          , Hh          , Mm          , Mm          , Mm          , Hh          , Rp          , Gg          , Gs          , Rp          , Gs^Fds      , Rd          , Rd^Es       , Ds          , Wwt         , Wot         , Wot         , Wot         , Wot         , Wot         , Wot         , Wot         , Wot         , Wot         , Wot         , Wot         , Wot         , Wot         
Wot         , Wot         , Wot         , Wot         , Wwt         , Wwt         , Wwt         , Wwt         , Wwt         , Wwt         , Ds          , Rp^Vhcr     , Chr         , Rp          , Chr         , Gs^Vh       , Gs          , Gs          , Hh          , Hh          , Hh          , Gs          , Gg          , Rp          , Rp^Vhcr     , Rp          , Gg          , Gs^Fds      , Gg          , Ds          , Wwt         , Wot         , Wot         , Wot         , Wot         , Wot         , Wot         , Wot         , Wot         , Wot         , Wot         , Wot         , Wot         , Wot         
Wot         , Wot         , Wot         , Wot         , Wwt         , Wwt         , Ds          , Ds          , Wwt         , Ds          , Gs          , Gs          , Rd          , Rr          , Rd          , Gs          , Gs^Fds      , Gs          , Gs^Es       , Rd          , Rd          , Rd          , Rd          , Rd^Es       , Rd          , Gg^Es       , Rd          , Gg          , Ds          , Wwt         , Wwt         , Wot         , Wot         , Wot         , Wot         , Wot         , Wot         , Wot         , Wot         , Wot         , Wot         , Wot         , Wot         , Wot         
Wot         , Wot         , Wot         , Wwt         , Ds          , Gs^Es       , Rp^Vhcr     , Gs          , Ds          , Ds          , Rr^Vhc      , Gs          , Rd^Es       , Gs          , Rr          , Gs          , Gs          , Gs          , Gs          , Gs          , Gs          , Gd^Fds      , Gs          , Rr          , Gs          , Rd          , Gs          , Rr          , Gg          , Ds          , Wwt         , Wwt         , Wot         , Wot         , Wot         , Wot         , Wot         , Wot         , Wot         , Wot         , Wot         , Wot         , Wot         , Wot         
Wot         , Wot         , Wwt         , Wwt         , Rr^Vhc      , Rd^Es       , Rd^Es       , Rd^Es       , Gg          , Rd          , Rp          , Rd          , Gs          , Gs          , Rd          , Gs          , Gs          , Gd^Fds      , Gll^Fds     , Gll^Fds     , Gll^Fds     , Gll^Fds     , Gll^Fds     , Rr^Vhc      , Gs          , Rd          , Gg          , Rr^Vhc      , Gg          , Gg          , Ds          , Wwt         , Wwt         , Wot         , Wot         , Wot         , Wot         , Wot         , Wot         , Wot         , Wot         , Wot         , Wot         , Wot         
Wot         , Wot         , Wwt         , Wwt         , Ds          , Ch          , Ch          , Ch          , Rr^Vhc      , Gs^Es       , Rp          , Gs          , Rd          , Gs^Es       , Gs          , Rd          , Gs^Fds      , Gll^Fds     , Gd^Fds      , Gd^Fds      , Gd^Fds      , Gll^Fds     , Re          , Rd          , Rd          , Rd          , Rd          , Rd          , Gs^Fds      , Ds          , Wwt         , Wwt         , Wwt         , Wot         , Wot         , Wot         , Wot         , Wot         , Wot         , Wot         , Wot         , Wot         , Wot         , Wot         
Wot         , Wot         , Wwt         , Wwt         , Ds          , Ch          , 3 Kh        , Ch          , Rr          , Rp          , Rd          , Rp^Vhcr     , Gs^Es       , Rd          , Rd          , Rd          , Re          , Re          , Re          , Gs^Vht      , Re          , Gll^Fds     , Re          , Gll^Fds     , Gd^Fds      , Rd^Es       , Rd          , Gs          , Gg          , Ds          , Wwt         , Wot         , Wot         , Wot         , Wot         , Wot         , Wot         , Wot         , Wot         , Wot         , Wot         , Wot         , Wot         , Wot         
Wot         , Wot         , Wwt         , Wwt         , Ds          , Ch          , Ch          , Ch          , Rp          , Rd          , Gs^Es       , Gs          , Rr          , Rr          , Ww          , Ww          , Gs^Vhr      , Gll^Fds     , Gll^Fds     , Re          , Gll^Fds     , Re          , Gll^Fds     , Rd          , Gd^Fds      , Rd          , Rd          , Gs          , Gs          , Ds^Es       , Wwt         , Wwt         , Wot         , Wot         , Wot         , Wot         , Wot         , Wot         , Wot         , Wot         , Wot         , Wot         , Wot         , Wot         
Wot         , Wot         , Wwt         , Gg          , Gg^Es       , Rr^Vhc      , Rr          , Rd          , Rp^Vhcr     , Rp          , Rr          , Rr          , Rr          , Gs          , Gg          , Ww          , Gs^Fds      , Gd^Fds      , Gll^Fds     , Gll^Fds     , Gll^Fds     , Gll^Fds     , Gd^Fds      , Rd          , Rd^Es       , Rd          , Rd          , Rd          , Gs          , Gs          , Ds          , Wwt         , Wwt         , Wot         , Wot         , Wot         , Wot         , Wot         , Wot         , Wot         , Wot         , Wot         , Wot         , Wot         
Wot         , Wot         , Wot         , Wwt         , Gg          , Rr          , Gs          , Rp          , Gs^Es       , Gs          , Gs          , Rd          , Gs          , Gs^Fds      , Gg          , Wwt         , Gs^Fds      , Gll^Fds     , Gll^Fds     , Gll^Fds     , Gd^Fds      , Ds          , Ds          , Ds          , Rd          , Rd          , Gs          , Gs          , Gs          , Ds          , Wwt         , Wwt         , Wot         , Wot         , Wot         , Wot         , Wot         , Wot         , Wot         , Wot         , Wot         , Wot         , Wot         , Wot         
Wot         , Wot         , Wot         , Wwt         , Wwt         , Ds          , Ds          , Wwt         , Gs          , Gs          , Gs^Vhc      , Gs          , Gg          , Gg          , Gg          , Wwt         , Gs          , Gd^Fds      , Gll^Fds     , Gd^Fds      , Ds          , Ds          , Wwt         , Ds          , Gs          , Rd          , Gs          , Rd          , Gs          , Wwt         , Wwt         , Wwt         , Wot         , Wot         , Wot         , Wot         , Wot         , Wot         , Wot         , Wot         , Wot         , Wot         , Wot         , Wot         
Wot         , Wot         , Wot         , Wot         , Wwt         , Wwt         , Wwt         , Wwt         , Wwt         , Wwt         , Ds          , Gg          , Ds          , Ds          , Ds          , Wwt         , Wwt         , Gs          , Gd^Fds      , Ds          , Wwt         , Wwt         , Wwt         , Wwt         , Wwt         , Gs^Vh       , Gs          , Wwt         , Wwt         , Wwt         , Wwt         , Wot         , Wot         , Wot         , Wot         , Wot         , Wot         , Wot         , Wot         , Wot         , Wot         , Wot         , Wot         , Wot         
Wot         , Wot         , Wot         , Wot         , Wot         , Wwt         , Wwt         , Wwt         , Wwt         , Wwt         , Wwt         , Ds          , Ds          , Wwt         , Ds          , Wwt         , Wwt         , Wwt         , Gs          , Wwt         , Wwt         , Wwt         , Wot         , Wwt         , Wwt         , Wwt         , Wwt         , Wwt         , Wwt         , Wwt         , Wot         , Wot         , Wot         , Wot         , Wot         , Wot         , Wot         , Wot         , Wot         , Wot         , Wot         , Wot         , Wot         , Wot         
Wot         , Wot         , Wot         , Wot         , Wot         , Wwt         , Wwt         , Wwt         , Wwt         , Wwt         , Wot         , Wwt         , Wwt         , Wwt         , Wwt         , Wwt         , Wot         , Wwt         , Wwt         , Wwt         , Wot         , Wot         , Wot         , Wot         , Wot         , Wwt         , Wwt         , Wwt         , Wwt         , Wwt         , Wwt         , Wot         , Wot         , Wot         , Wot         , Wot         , Wot         , Wot         , Wot         , Wot         , Wot         , Wot         , Wot         , Wot         
Wot         , Wot         , Wot         , Wot         , Wot         , Wot         , Wot         , Wot         , Wot         , Wot         , Wot         , Wot         , Wot         , Wwt         , Wot         , Wot         , Wot         , Wwt         , Wwt         , Wwt         , Wot         , Wot         , Wot         , Wot         , Wot         , Wot         , Wwt         , Wwt         , Wot         , Wwt         , Wot         , Wot         , Wot         , Wot         , Wot         , Wot         , Wot         , Wot         , Wot         , Wot         , Wot         , Wot         , Wot         , Wot         
Wot         , Wot         , Wot         , Wot         , Wot         , Wot         , Wot         , Wot         , Wot         , Wot         , Wot         , Wot         , Wot         , Wot         , Wot         , Wot         , Wot         , Wot         , Wot         , Wot         , Wot         , Wot         , Wot         , Wot         , Wot         , Wot         , Wot         , Wot         , Wot         , Wot         , Wot         , Wot         , Wot         , Wot         , Wot         , Wot         , Wot         , Wot         , Wot         , Wot         , Wot         , Wot         , Wot         , Wot         
Wot         , Wot         , Wot         , Wot         , Wot         , Wot         , Wot         , Wot         , Wot         , Wot         , Wot         , Wot         , Wot         , Wot         , Wot         , Wot         , Wot         , Wot         , Wot         , Wot         , Wot         , Wot         , Wot         , Wot         , Wot         , Wot         , Wot         , Wot         , Wot         , Wot         , Wot         , Wot         , Wot         , Wot         , Wot         , Wot         , Wot         , Wot         , Wot         , Wot         , Wot         , Wot         , Wot         , Wot         
Wot         , Wot         , Wot         , Wot         , Wot         , Wot         , Wot         , Wot         , Wot         , Wot         , Wot         , Wot         , Wot         , Wot         , Wot         , Wot         , Wot         , Wot         , Wot         , Wot         , Wot         , Wot         , Wot         , Wot         , Wot         , Wot         , Wot         , Wot         , Wot         , Wot         , Wot         , Wot         , Wot         , Wot         , Wot         , Wot         , Wot         , Wot         , Wot         , Wot         , Wot         , Wot         , Wot         , Wot         
