border_size=1
usage=map

Gs^Fds      , Gs^Fds      , Gs^Fds      , Gs^Fds      , Gs^Fds      , Gg          , Gg          , Gg          , Gg          , Gg          , Gg          , Gg          , Gg          , Gg          , Gg          , Gg          , Gg          , Gg          , Gg          , Gg          , Gg          , Gg          , Gg          , Rr          , Gg          , Gg          , Gg          , Gg          , Gg          , Gg          , Gg          , Gg          , Gg          , Gg          , Gg          , Gg          , Gg          , Gg          , Gg          , Gg          , Gg          , Gg          , Gg          , Gg          , Gg          , Gg          , Gg          , Gg          , Gg          , Gg          , Gg          , Gg          , Gg          , Gg          
Gs^Fds      , Gs^Fds      , Gg          , Gg          , Gg          , Gg          , Gg          , Gg          , Gg          , Gg^Vh       , Gg          , Gg          , Gg          , Gg          , Gg          , Gg          , Gg          , Gg          , Gg          , Gg          , Gg          , Gg          , Gg          , Rr          , Gg          , Gg          , Gg          , Gg          , Gg          , Gg^Vh       , Gg          , Gg          , Gg          , Gg          , Gg          , Gg          , Gg          , Gg          , Gg          , Gg          , Gg          , Gg          , Gg          , Gg          , Gg          , Gg          , Gg          , Gg          , Gg          , Gg          , Gg          , Gg          , Gg          , Gg          
Gs^Fds      , Gs^Fds      , Gg          , Gg          , Gg          , Gg          , Gg          , Gg          , Gg          , Gg          , Gg          , Gg          , Gg          , Gg          , Gg          , Gg          , Gg          , Gg          , Gg          , Gg          , Gg          , Gg          , Gg          , Rr          , Gg          , Gg          , Gg          , Gg          , Gg          , Gg          , Gg          , Gg          , Gg          , Gg          , Gg          , Gg          , Gg          , Gg          , Gg          , Gg          , Gg          , Gg          , Gg          , Gg          , Gg          , Gg          , Gg          , Gg^Vh       , Gg          , Gg          , Gg          , Gg          , Gg          , Gg          
Gs^Fds      , Gg          , Gg          , Gg          , Gg          , Gg          , Gg^Es       , Gg          , Gg          , Gg          , Gg          , Gg          , Gg          , Gg          , Ch          , Ch          , Ch          , Ch          , Ch          , Ch          , Ch          , Ch          , Kh          , Rr          , Kh          , Ch          , Ch          , Ch          , Ch          , Ch          , Ch          , Ch          , Ch          , Ch          , Ch          , Ch          , Ch          , Ch          , Ch          , Ch          , Ch          , Gg          , Gg          , Gg          , Gg          , Gg          , Gg          , Gg          , Gg          , Gg          , Gg          , Gg          , Gg          , Gg          
Gg          , Gg          , Gg          , Gg          , Gg          , Gg          , Gg          , Gg          , Gg          , Gg          , Gg          , Gg          , Ch          , Ch          , Gg          , Gg          , Gg          , Gg          , Gg          , Gg          , Gg          , Gg          , Gg          , Rr          , Gg          , Gg          , Gg          , Gg          , Gg          , Gg          , Gg          , Gg          , Gg          , Gg          , Gg          , Gg          , Gg          , Gg          , Gg          , Gg          , Gg          , Ch          , Ch          , Gg          , Gg          , Gg          , Gg          , Gg          , Gg          , Gg          , Gg          , Gg          , Rr          , Rr          
Gg          , Gg          , Gg          , Gg^Vh       , Gg          , Gg          , Gg          , Gg          , Gg          , Gg          , Ch          , Ch          , Gg          , Rd          , Re^Gvs      , Re^Gvs      , Re^Gvs      , Re^Gvs      , Gg          , Gg^Efm      , Re^Gvs      , Re^Gvs      , Gg^Vwm      , Rr          , Gg          , Gg          , Gg          , Re^Gvs      , Re^Gvs      , Re^Gvs      , Re^Gvs      , Gg^Vh       , Gg          , Re^Gvs      , Re^Gvs      , Rd          , Rd          , Gg          , Gg          , Gg^Vh       , Gg          , Gg          , Gg          , Ch          , Ch          , Gg^Efm      , Gg          , Gg          , Gg          , Gg          , Rr          , Rr          , Gg          , Gg          
Gg          , Gg          , Gg          , Gg          , Gg          , Gg^Efm      , Gg^Efm      , Gg          , Ch          , Ch          , Gg          , Gg          , Gg          , Gg          , Gg          , Gg          , Re^Gvs      , Gg          , Rd          , Re^Gvs      , Re^Gvs      , Re^Gvs      , Gg          , Rr          , Rr          , Gg^Vh       , Rd          , Re^Gvs      , Re^Gvs      , Re^Gvs      , Re^Gvs      , Gg          , Rd          , Re^Gvs      , Gg^Efm      , Gg          , Re^Gvs      , Re^Gvs      , Re^Gvs      , Re^Gvs      , Re^Gvs      , Gg          , Gg          , Gg          , Gg          , Ch          , Gg          , Gg          , Gg          , Gg          , Rr          , Rr          , Gg          , Gg          
Gg          , Gg          , Gg          , Gg          , Gg          , Gg^Efm      , Ch          , Ch          , Gg          , Gg          , Gg          , Gg^Es       , Gg          , Gg^Efm      , Gg          , Gg^Vh       , Gg          , Rd          , Gg          , Re^Gvs      , Re^Gvs      , Gg^Vh       , Re^Gvs      , Rr          , Rr          , Rd          , Gg          , Gg          , Gg^Vh       , Re^Gvs      , Re^Gvs      , Re^Gvs      , Gg          , Gg          , Gg          , Gg          , Re^Gvs      , Re^Gvs      , Re^Gvs      , Re^Gvs      , Re^Gvs      , Gg^Efm      , Gg          , Gg^Efm      , Gg          , Ch          , Ch          , Gg          , Rr          , Rr          , Gg          , Gg          , Gg          , Gg          
Gg          , Gg          , Gg          , Gg          , Gg          , Ch          , Gg          , Gg          , Gs^Fds      , Gg          , Gg          , Gg^Efm      , Gs^Fds      , Gg          , Gg          , Gs^Fds      , Gs^Fds      , Gs^Fds      , Rd          , Re^Gvs      , Re^Gvs      , Re^Gvs      , Re^Gvs      , Gg          , Rr          , Gg          , Gg^Efm      , Gg^Eff      , Gg^Eff      , Re^Gvs      , Gg          , Rd          , Re^Gvs      , Gg^Vh       , Rd          , Rd          , Gg^Vh       , Gg^Efm      , Re^Gvs      , Re^Gvs      , Gg^Efm      , Rd          , Re^Gvs      , Gg          , Gg          , Kh          , Rr          , Rr          , Ch          , Gg          , Gg^Efm      , Gg^Efm      , Gg          , Gg          
Rr          , Gg          , Rr          , Gg          , Ch          , Ch          , Gg          , Gg          , Gg          , Gg          , Gg          , Gs^Fds      , Gs^Fds      , Gs^Fds      , Gg          , Gs^Fds      , Gs^Fds      , Gg^Efm      , Re^Gvs      , Gg          , Gg^Efm      , Gg          , Rd          , Gg          , Rr          , Gg          , Gg^Eff      , Gg^Eff      , Gg          , Rd          , Gg          , Gg          , Re^Gvs      , Re^Gvs      , Gg^Efm      , Gg          , Gg          , Rd          , Gg          , Gg          , Gg^Vh       , Re^Gvs      , Gg          , Gg          , Rr          , Rr          , Gg          , Kh          , Ch          , Gg          , Gg          , Gg          , Gg          , Gg          
Rr          , Rr          , Rr          , Rr          , Rr          , Kh          , Rr          , Gg          , Rr          , Rr          , Rr          , Gs^Fds      , Gs^Fds      , Gs^Fds      , Gg          , Gs^Fds      , Gs^Fds      , Re^Gvs      , Re^Gvs      , Gg^Vh       , Gg          , Rd          , Gg^Es       , Gg^Vh       , Rr          , Gg^Efm      , Gg          , Gg^Vh       , Ch          , Ch          , Ch          , Gg          , Re^Gvs      , Re^Gvs      , Gg^Vwm      , Gg          , Re^Gvs      , Rd          , Gg          , Gg^Efm      , Gg          , Rd          , Rr          , Rr          , Gg          , Gg          , Gg^Es       , Gg          , Gg          , Ch          , Gg          , Gg          , Gg          , Gg          
Gg          , Rr          , Gg          , Rr          , Kh          , Rr          , Rr          , Rr          , Gg          , Gg          , Gg          , Rr          , Rr          , Gg          , Gg^Vh       , Gg          , Rd          , Re^Gvs      , Re^Gvs      , Rd          , Re^Gvs      , Re^Gvs      , Gg          , Gg          , Rr          , Gg          , Gg          , Gg          , Ch          , 5 Kh        , Ch          , Gg^Es       , Gg          , Re^Gvs      , Re^Gvs      , Re^Gvs      , Re^Gvs      , Gg          , Gg          , Gg          , Rr          , Rr          , Re^Gvs      , Re^Gvs      , Gg^Efm      , Gg^Es       , Gg^Es       , Gg^Vh       , Gg          , Ch          , Gg          , Gg          , Gg          , Gg          
Gg          , Gg          , Gg          , Gg          , Ch          , Ch          , Gg          , Gg^Efm      , Gs^Fds      , Gs^Fds      , Gg^Eff      , Gg^Eff      , Gg          , 1 Rr        , Rr          , Rd          , Gg          , Gg          , Gg^Vh       , Gg          , Re^Gvs      , Re^Gvs      , Ch          , Ch          , Rr          , Ch          , Ch          , Rr          , Rr^Vhc      , Ch          , Rr^Vhc      , Gg          , Gg^Efm      , Re^Gvs      , Re^Gvs      , Re^Gvs      , Gg          , Gg^Efm      , Rr          , Rr          , Gg          , Re^Gvs      , Re^Gvs      , Re^Gvs      , Gg          , Gg          , Gg^Eff      , Gg^Eff      , Gg          , Ch          , Gg          , Gg          , Gg          , Gg          
Gg          , Gg          , Gg          , Ch          , Gg          , Gg          , Gg          , Gg          , Gg          , Gg^Eff      , Gg^Eff      , Gg^Vh       , Rd          , Rd          , Gg          , Rr          , Rr          , Gg          , Gg          , Gg          , Ch          , Ch          , Rr          , Rr          , Rr          , Rr^Vhc      , Rr^Vhc      , Ch          , Rr          , Rr          , Gg          , Gg          , Gg^Vh       , Gg          , Rd          , Gg          , Rr          , Rr          , Gg          , Gg          , Rd          , Rd          , Gg^Efm      , Rd          , Gg          , Gg          , Gg^Eff      , Gg          , Gg          , Ch          , Gg^Efm      , Gg          , Gg^Vh       , Gg          
Gg          , Gg          , Gg          , Ch          , Gg          , Gg          , Gg          , Gg          , Kh          , Gg          , Gg          , Gg          , Re^Gvs      , Gg          , Gg^Vwm      , Gg^Efm      , Gg^Vh       , Rr          , Rr          , Ch          , Rr          , Rr^Vhc      , Rr          , Rr^Vhc      , Rrc         , Rr          , Rr          , Rr          , Rr          , Ch          , Ch          , Gg          , Gg          , Gg          , Rr          , Rr          , Gg^Eff      , Gg^Eff      , Re^Gvs      , Re^Gvs      , Gg          , Gg^Vh       , Rd          , Rd          , Gg^Efm      , Gg^Efm      , Gg^Vwm      , Gg^Eff      , Gg^Eff      , Ch          , Gg          , Gg          , Gg          , Gg          
Gg          , Gg          , Gg          , Ch          , Gg^Efm      , Gg^Efm      , Kh          , Kh          , Rrc         , Kh          , Kh          , Gg          , Re^Gvs      , Re^Gvs      , Gg          , Gg          , Ch          , Ch          , Rr          , Rr          , Rr^Vhc      , Rr          , Rrc         , Rrc         , Ww^Bsb|     , Rrc         , Rrc         , Rr^Vhc      , Rr          , Rr^Vhc      , Rr^Vhc      , Ch          , Rr          , Rr          , Gg          , Gg^Vh       , Gg^Efm      , Re^Gvs      , Re^Gvs      , Re^Gvs      , Gg^Efm      , Gg          , Re^Gvs      , Gg          , Re^Gvs      , Gg^Efm      , Re^Gvs      , Gg^Eff      , Gg          , Ch          , Gg          , Gg          , Gg          , Gg          
Gg          , Gg          , Gg          , Ch          , Gg          , Gg^Efm      , Kh          , Rrc         , Rrc         , Rrc         , Kh          , Gg^Efm      , Gg^Efm      , Re^Gvs      , Gg          , Gg          , Ch          , Rr          , Rr^Vhc      , Rr          , Rrc         , Rrc         , Ww          , Ww          , Rr          , Ww          , Ww          , Rrc         , Rrc         , Rr          , Rr          , Rr          , Ch          , Gg          , Rd          , Rd          , Rd          , Re^Gvs      , Gg^Es       , Gg          , Gg          , Re^Gvs      , Re^Gvs      , Re^Gvs      , Re^Gvs      , Re^Gvs      , Re^Gvs      , Re^Gvs      , Gg          , Ch          , Gg          , Gg          , Gg          , Gg          
Gg          , Gg          , Gg^Efm      , Ch          , Gg          , Gg          , Kh          , Rrc         , Rrc         , Rrc         , Rrc         , Gg^Vh       , Gg          , Rd          , Ch          , Rr          , Rr          , Rr          , Rr          , Rrc         , Ww          , Ww^Bsb\     , Rr          , Rr          , Ch          , Rr^Vhc      , Rr          , Ww          , Ww^Bsb/     , Rrc         , Rr          , Rr^Vhc      , Ch          , Gg          , Re^Gvs      , Gg          , Gg          , Rd          , Gg          , Gg^Vh       , Gg          , Re^Gvs      , Re^Gvs      , Re^Gvs      , Gg          , Re^Gvs      , Re^Gvs      , Re^Gvs      , Re^Gvs      , Ch          , Gg          , Gg          , Gg          , Gg          
Gg          , Gg^Efm      , Gg^Efm      , Ch          , Gg          , Gg          , Gg          , Kh          , Kh          , Kh          , Gg          , Rrc         , Rr          , Ch          , 3 Kh        , Ch          , Rr^Vhc      , Rr          , Rr^Vhc      , Rrc         , Ww          , Rr^Vhc      , Ch          , Gg^Fet      , Ch          , Gg^Fet      , Ch          , Rr          , Ww          , Rrc         , Rr^Vhc      , Rr          , Ch          , Gg^Efm      , Re^Gvs      , Gg^Vh       , Re^Gvs      , Re^Gvs      , Rd          , Rd          , Rd          , Gg          , Re^Gvs      , Re^Gvs      , Gg          , Gg^Vh       , Rd          , Gg          , Gg          , Ch          , Gg          , Gg          , Gg          , Gg          
Gg          , Gg          , Gg          , Ch          , Gg          , Gg          , Gg          , Gg          , Gg          , Gg          , Gg^Efm      , Gg          , Gg          , Ch          , Ch          , Ch          , Rr          , Rr          , Rr^Vhc      , Rrc         , Ww          , Rr          , Rr^Vhc      , Ch          , 2 Kh        , Ch          , Rr          , Rr^Vhc      , Ww          , Rrc         , Rr          , Rr          , Rrc         , Gg          , Gg          , Re^Gvs      , Re^Gvs      , Re^Gvs      , Gg          , Gg^Efm      , Gg          , Re^Gvs      , Re^Gvs      , Re^Gvs      , Rd          , Rd          , Gg          , Re          , Gg^Efm      , Ch          , Gg^Vh       , Gg          , Gg          , Gg          
Gg          , Gg^Vh       , Gg          , Ch          , Gs^Fds      , Gg          , Gs^Fds      , Gs^Fds      , Gg          , Gg          , Re^Gvs      , Gg          , Rd          , Rd          , Gg          , Rr          , Ch          , Rr          , Rr          , Rrc         , Ww          , Ww          , Rr          , Ch          , Ch          , Ch          , Rr          , Ww          , Ww          , Rrc         , Rr^Vhc      , Rr          , Ch          , Ch          , Ch          , Re^Gvs      , Gg          , Rd          , Re^Gvs      , Gg^Vwm      , Re^Gvs      , Rd          , Gg^Vh       , Gg^Efm      , Gg          , Gg          , Gg          , Re          , Gg          , Ch          , Gg          , Gg          , Gg          , Gg          
Gg          , Gg          , Gg          , Ch          , Gs^Fds      , Gs^Fds      , Gs^Fds      , Gs^Fds      , Gs^Fds      , Re^Gvs      , Re^Gvs      , Re^Gvs      , Gg^Eff      , Gg          , Gg^Efm      , Gg          , Ch          , Rr          , Rr^Vhc      , Rrc         , Ww^Bsb/     , Ww^Bsb/     , Ww          , Rr          , Ch          , Rr          , Ww          , Ww^Bsb\     , Ww^Bsb\     , Rrc         , Rr          , Rr          , Ch          , 4 Kh        , Ch          , Gg          , Gg^Efm      , Gg^Vh       , Re^Gvs      , Re^Gvs      , Re^Gvs      , Gg^Eff      , Gg^Eff      , Gg^Eff      , Gg          , Ww          , Ww          , Ww^Bw|      , Ww          , Ch          , Ww          , Ww          , Ww          , Ww          
Gg          , Gg^Efm      , Gg          , Ch          , Gg          , Gs^Fds      , Gs^Fds      , Gs^Fds      , Gs^Fds      , Gs^Fds      , Rd          , Gg^Vwm      , Gg^Vh       , Gg^Eff      , Gg          , Gg          , Ch          , Rr          , Rr          , Rrc         , Rrc         , Ww          , Ww          , Rr^Vhc      , Rr          , Rr^Vhc      , Ww          , Ww          , Ww          , Rrc         , Rr          , Rr          , Rr^Vhc      , Ch          , Rr          , Rr          , Gg          , Gg          , Re^Gvs      , Re^Gvs      , Ww          , Ww          , Ww          , Ww          , Ww          , Ww          , Ww          , Ww^Bw|      , Ww          , Ch          , Ww          , Ww          , Ww          , Ww          
Gg          , Gg^Efm      , Gg          , Ch          , Gg          , Gs^Fds      , Gs^Fds      , Gs^Fds      , Gg^Efm      , Gs^Fds      , Gg          , Re^Gvs      , Re^Gvs      , Re^Gvs      , Gg          , Gg          , Rr          , Rr          , Rr          , Rr^Vhc      , Rr          , Rrc^Vhc     , Rrc         , Ww          , Ww^Bsb|     , Ww          , Rrc         , Rrc^Vhc     , Ww          , Rrc^Vhc     , Ww          , Rr          , Rr          , Rr          , Rr^Vhc      , Ch          , Ch          , Ch          , Ww          , Ww          , Ww          , Ww          , Ww          , Ww          , Ww          , Ww          , Ww          , Ww^Bw|      , Ww          , Ch          , Ww          , Ww          , Ww          , Ww          
Gg          , Gg          , Gg          , Ch          , Gg          , Gg          , Gs^Fds      , Gs^Fds      , Gg          , Gg^Efm      , Gg          , Re^Gvs      , Re^Gvs      , Re^Gvs      , Rr          , Rr          , Gg          , Ch          , Ch          , Rr          , Rr^Vhc      , Rr          , Rr^Vhc      , Rrc         , Rrc         , Rrc         , Rr          , Rr          , Ch          , Ww          , Ww          , Ww          , Ww          , Rr          , Ww^Bsb\     , Ww          , Ww          , Ww          , Ww          , Ww          , Ww          , Ww          , Ww          , Ww          , Ww          , Ww          , Gg          , Re          , Gg          , Ch          , Gg          , Gg          , Gg          , Gg          
Gg          , Gg          , Gg          , Ch          , Gg          , Gg          , Gg          , Gs^Fds      , Gg^Eff      , Gg^Vh       , Gg^Eff      , Re^Gvs      , Rr          , Rr          , Gg          , Gg          , Gg          , Gg          , Gg          , Ch          , Ch          , Rr          , Rr          , Rr          , Rr          , Rr          , Rr^Vhc      , Rr          , Ww          , Ww          , Ww          , Ww          , Ww          , Ww          , Ww          , Ww^Bsb\     , Ww^Bsb\     , Ww          , Ww          , Ww          , Gg          , Ww          , Gg          , Gg          , Gg          , Gg          , Re          , Re          , Gg          , Ch          , Gg          , Gg          , Gg          , Gg          
Gg          , Gg          , Gg          , Ch          , Ch          , Gg          , Gg          , Gg          , Gg          , Gg^Eff      , Rr          , Rr          , Gg          , Gg          , Gg          , Gg^Efm      , Gg          , Gg          , Gg          , Gg          , Gg^Efm      , Ch          , Ww          , Ww          , Ww          , Ww          , Ww          , Ww^Bsb|     , Ww          , Ww          , Ww          , Ww          , Ww          , Ww          , Ww          , Ww          , Gg^Vhc      , Rr          , Rr          , Gg          , Gg          , Gg          , Gg          , Gg^Efm      , Re          , Re          , Gg^Efm      , Gg          , Gg          , Ch          , Gg          , Gg          , Gg^Vh       , Gg          
Gg          , Gg          , Gg          , Gg          , Gg          , Ch          , Kh          , Gg          , Rr          , Rr          , Re          , Gg          , Gg          , Gg^Vh       , Gg          , Gg          , Gg          , Gg          , Ww          , Ww          , Ww          , Ww          , Ww          , Ww          , Ww          , Ww          , Ww          , Ww^Bsb|     , Ww          , Ww          , Ww          , Ww          , Gg^Es       , Gg^Es       , Gg          , Gg          , Gg          , Ch          , Gg          , Rr          , Rr          , Gg^Efm      , Rr          , Re          , Gg          , Gg          , Gg          , Gg^Es       , Ch          , Ch          , Gg          , Gg^Efm      , Gg          , Gg          
Gg          , Gg          , Gg^Efm      , Gg          , Gg          , Ch          , Rr          , Rr          , Kh          , Gg          , Re          , Gg^Efm      , Gg          , Gg          , Gg          , Ww          , Ww          , Ww          , Ww          , Ww          , Ww          , Ww          , Ww          , Ww          , Ww          , Ww          , Gg^Efm      , Rr          , Gg          , Gg          , Gg          , Gg          , Gg          , Gg          , Gg^Efm      , Gg          , Gg          , Gg          , Gg          , Gg          , Re          , Rr          , Gg          , Rr          , Rr          , Gg          , Kh          , Ch          , Gg          , Gg          , Gg          , Gg          , Gg          , Gg          
Gg          , Gg^Efm      , Gg^Efm      , Gg          , Rr          , Rr          , Gg          , Ch          , Ch          , Gg          , Ww          , Ww^Bw\      , Ww^Bw\      , Ww          , Ww          , Ww          , Ww          , Ww          , Ww          , Ww          , Ww          , Ww          , Gg          , Gg          , Gg^Eff      , Gg          , Gg          , Rr          , Gg          , Gg          , Gg          , Gg          , Gg          , Gg          , Gg^Vh       , Gg          , Re          , Re          , Re          , Re          , Gg          , Gg          , Gg          , Gg          , Kh          , Rr          , Rr          , Ch          , Gg          , Gg          , Gg^Efm      , Gg^Es       , Gg          , Hh          
Gg          , Gg^Efm      , Rr          , Rr          , Gg          , Gg          , Gg          , Gg          , Ch          , Ww          , Ww          , Ww          , Ww          , Ww^Bw\      , Ww^Bw\      , Ww          , Ww          , Ww          , Gg^Es       , Gg          , Gg          , Gg^Efm      , Gg          , Gg^Eff      , Gg^Vh       , Gg^Eff      , Gg          , Rr          , Rr          , Re          , Re          , Re          , Re          , Re          , Re          , Re          , Gg^Efm      , Gg^Efm      , Gg^Efm      , Gg          , Gg          , Gg^Efm      , Gg          , Gg^Efm      , Ch          , Ch          , Gg          , Rr          , Rr          , Gg          , Gg          , Gg          , Hh          , Hh          
Rr          , Rr          , Gg^Vh       , Gg          , Gg^Efm      , Gg^Efm      , Gg^Efm      , Gg          , Ww          , Ch          , Ch          , Ww          , Ww          , Ww          , Ww          , Ww^Bw\      , Ww^Bw\      , Ww          , Re          , Re          , Re          , Re          , Re          , Re          , Re          , Re          , Re          , Rr          , Rr          , Gg          , Gg          , Gg^Efm      , Gg          , Gg          , Gg          , Gg          , Gg          , Gg^Efm      , Gg          , Gg          , Gg          , Gg          , Gg          , Gg          , Ch          , Gg          , Gg          , Rr          , Rr          , Gg          , Hh          , Gg          , Hh          , Hh          
Gg          , Gg          , Gg          , Gg          , Gg          , Gg^Efm      , Gg          , Gg          , Ww          , Ww          , Ww          , Ch          , Ch          , Ww          , Ww          , Ww          , Gg          , Re          , Gg          , Gg^Efm      , Gg          , Gg          , Gg          , Gg          , Gg          , Gg          , Gg          , Gg          , Rr          , Gg          , Gg          , Gg          , Gg          , Gg          , Gg          , Gg          , Gg          , Gg          , Gg          , Gg          , Gg          , Gg          , Ch          , Ch          , Gg          , Gg          , Gg          , Hh          , Hh          , Rr          , Rr          , Hh          , Hh          , Hh          
Gg          , Gg          , Gg          , Gg          , Gg          , Gg          , Gg          , Ww          , Ww          , Ww          , Ww          , Ww          , Gg          , Ch          , Ch          , Ch          , Ch          , Ch          , Ch          , Ch          , Ch          , Ch          , Ch          , Ch          , Ch          , Ch          , Ch          , Kh          , Rr          , Kh          , Ch          , Ch          , Ch          , Ch          , Ch          , Ch          , Ch          , Ch          , Ch          , Ch          , Ch          , Ch          , Gg          , Gg          , Gg          , Gg          , Gg^Efm      , Gg^Es       , Hh          , Hh          , Hh          , Rr          , Rr          , Hh          
Gg          , Gg          , Gg^Efm      , Gg          , Gg          , Gg          , Ww          , Ww          , Ww          , Ww          , Ww          , Ww          , Gg          , Gg          , Gg          , Gg          , Gg          , Gg          , Gg          , Gg          , Gg          , Gg          , Gg          , Gg          , Gg          , Gg          , Gg          , Gg          , Rr          , Gg          , Gg          , Gg          , Gg          , Gg          , Gg          , Gg          , Gg          , Gg          , Gg          , Gg          , Gg          , Gg          , Gg          , Gg          , Gg          , Gg          , Gg^Vh       , Gg^Es       , Gg          , Hh          , Hh          , Hh          , Hh          , Rr          
Gg          , Gg          , Gg          , Gg          , Gg          , Ww          , Ww          , Ww          , Ww          , Ww          , Ww          , Gg          , Gg^Efm      , Gg          , Gg          , Gg          , Gg          , Gg          , Gg^Efm      , Gg          , Gg          , Gg          , Gg          , Gg          , Gg^Efm      , Gg          , Gg          , Gg          , Rr          , Gg          , Gg          , Gg          , Gg          , Gg          , Gg          , Gg          , Gg^Vh       , Gg          , Gg^Efm      , Gg          , Gg          , Gg          , Gg          , Gg^Efm      , Gg^Efm      , Gg^Es       , Gg          , Gg          , Gg          , Hh          , Hh          , Hh          , Hh          , Hh          
Gg^Efm      , Gg          , Gg          , Gg          , Ww          , Ww          , Ww          , Ww          , Ww          , Ww          , Gg          , Gg          , Gg          , Gg          , Gg          , Gg          , Gg          , Gg          , Gg          , Gg          , Gg          , Gg          , Gg          , Gg          , Gg          , Gg          , Gg^Es       , Gg          , Rr          , Gg          , Gg          , Gg          , Gg^Efm      , Gg          , Gg          , Gg          , Gg          , Gg          , Gg          , Gg          , Gg          , Gg          , Gg          , Gg^Efm      , Gg          , Gg          , Gg          , Gg          , Hh          , Hh          , Hh          , Hh          , Hh          , Hh          
